################################################################################
#                                                                              #
#                                                                              #
#                                                                              #
#                                                                              #
#                              #####################                           #
#                              #  ##################                           #
#                              #  #               ##                           #
#                              #  #               ##                           #
#                              #  #######O###     ##                           #
#                              #       #    #     ##                           #
#                              #       #    #  #####                           #
#                              #########    ########                           #
#                                                                              #
#                                                                              #
#                                                                              #
#                                                                              #
#                                                                              #
################################################################################

	Name user: 
	Name map: 
	Width map: 80
	Height map: 19
